NO ./resources/slowpok.xpm
SO ./resources/poke2.xpm
WE ./resources/pikapika.xpm
EA ./resources/charmander.xpm

C 255,230,255
F 255, 0, 0

1111111111111
1000010000101
1001000S10001
1101101000001
1101101000001
1101101000001
1101001000001
1100001001001
1101101000001
1111111111111